out_run = 	(Float_t)(*run);
out_event = 	(Float_t)(*event);
out_lumi = 	(Float_t)(*lumi);
out_numPrimaryVertices = 	(Float_t)(*numPrimaryVertices);
out_trigger = 	(Float_t)(*trigger);
out_noXCandidates = 	(Float_t)(*noXCandidates);
out_dimuon_id = 	(Float_t)(*dimuon_id);
out_p_id = 	(Float_t)(*p_id);
out_m_id = 	(Float_t)(*m_id);
out_dimuonditrk_p4 = 	(Float_t)(*dimuonditrk_p4);
out_ditrack_p4 = 	(Float_t)(*ditrack_p4);
out_dimuon_p4 = 	(Float_t)(*dimuon_p4);
out_lowMuon_p4 = 	(Float_t)(*lowMuon_p4);
out_highMuon_p4 = 	(Float_t)(*highMuon_p4);
out_highKaon_p4 = 	(Float_t)(*highKaon_p4);
out_lowKaon_p4 = 	(Float_t)(*lowKaon_p4);
out_dimuonditrk_rf_p4 = 	(Float_t)(*dimuonditrk_rf_p4);
out_ditrack_rf_p4 = 	(Float_t)(*ditrack_rf_p4);
out_dimuon_rf_p4 = 	(Float_t)(*dimuon_rf_p4);
out_lowMuon_rf_p4 = 	(Float_t)(*lowMuon_rf_p4);
out_highMuon_rf_p4 = 	(Float_t)(*highMuon_rf_p4);
out_kaonp_rf_p4 = 	(Float_t)(*kaonp_rf_p4);
out_kaonn_rf_p4 = 	(Float_t)(*kaonn_rf_p4);
out_dimuonditrk_m = 	(Float_t)(*dimuonditrk_m);
out_dimuonditrk_m_rf = 	(Float_t)(*dimuonditrk_m_rf);
out_dimuonditrk_m_rf_d_c = 	(Float_t)(*dimuonditrk_m_rf_d_c);
out_dimuonditrk_m_rf_c = 	(Float_t)(*dimuonditrk_m_rf_c);
out_dimuonditrk_pt = 	(Float_t)(*dimuonditrk_pt);
out_dimuonditrk_eta = 	(Float_t)(*dimuonditrk_eta);
out_dimuonditrk_phi = 	(Float_t)(*dimuonditrk_phi);
out_dimuonditrk_y = 	(Float_t)(*dimuonditrk_y);
out_dimuonditrk_vx = 	(Float_t)(*dimuonditrk_vx);
out_dimuonditrk_vy = 	(Float_t)(*dimuonditrk_vy);
out_dimuonditrk_vz = 	(Float_t)(*dimuonditrk_vz);
out_pv_x = 	(Float_t)(*pv_x);
out_pv_y = 	(Float_t)(*pv_y);
out_pv_z = 	(Float_t)(*pv_z);
out_dimuon_m = 	(Float_t)(*dimuon_m);
out_dimuon_pt = 	(Float_t)(*dimuon_pt);
out_ditrack_m = 	(Float_t)(*ditrack_m);
out_ditrack_pt = 	(Float_t)(*ditrack_pt);
out_highKaon_pt = 	(Float_t)(*highKaon_pt);
out_lowKaon_pt = 	(Float_t)(*lowKaon_pt);
out_highMuon_pt = 	(Float_t)(*highMuon_pt);
out_lowMuon_pt = 	(Float_t)(*lowMuon_pt);
out_highKaon_eta = 	(Float_t)(*highKaon_eta);
out_lowKaon_eta = 	(Float_t)(*lowKaon_eta);
out_highMuon_eta = 	(Float_t)(*highMuon_eta);
out_lowMuon_eta = 	(Float_t)(*lowMuon_eta);
out_highKaon_phi = 	(Float_t)(*highKaon_phi);
out_lowKaon_phi = 	(Float_t)(*lowKaon_phi);
out_highMuon_phi = 	(Float_t)(*highMuon_phi);
out_lowMuon_phi = 	(Float_t)(*lowMuon_phi);
out_highKaon_dxy = 	(Float_t)(*highKaon_dxy);
out_lowKaon_dxy = 	(Float_t)(*lowKaon_dxy);
out_highMuon_dxy = 	(Float_t)(*highMuon_dxy);
out_lowMuon_dxy = 	(Float_t)(*lowMuon_dxy);
out_highKaon_dz = 	(Float_t)(*highKaon_dz);
out_lowKaon_dz = 	(Float_t)(*lowKaon_dz);
out_highMuon_dz = 	(Float_t)(*highMuon_dz);
out_lowMuon_dz = 	(Float_t)(*lowMuon_dz);
out_highKaonMuonDR = 	(Float_t)(*highKaonMuonDR);
out_highKaonMuonDP = 	(Float_t)(*highKaonMuonDP);
out_highKaonMuonDPt = 	(Float_t)(*highKaonMuonDPt);
out_lowKaonMuonDR = 	(Float_t)(*lowKaonMuonDR);
out_lowKaonMuonDP = 	(Float_t)(*lowKaonMuonDP);
out_lowKaonMuonDPt = 	(Float_t)(*lowKaonMuonDPt);
out_dimuonditrk_refPK_mass = 	(Float_t)(*dimuonditrk_refPK_mass);
out_dimuonditrk_refKP_mass = 	(Float_t)(*dimuonditrk_refKP_mass);
out_dimuonditrk_refPP_mass = 	(Float_t)(*dimuonditrk_refPP_mass);
out_dimuonditrk_refPK_vChi2 = 	(Float_t)(*dimuonditrk_refPK_vChi2);
out_dimuonditrk_refKP_vChi2 = 	(Float_t)(*dimuonditrk_refKP_vChi2);
out_dimuonditrk_refPP_vChi2 = 	(Float_t)(*dimuonditrk_refPP_vChi2);
out_dimuonditrk_refPK_nDof = 	(Float_t)(*dimuonditrk_refPK_nDof);
out_dimuonditrk_refKP_nDof = 	(Float_t)(*dimuonditrk_refKP_nDof);
out_dimuonditrk_refPP_nDof = 	(Float_t)(*dimuonditrk_refPP_nDof);
out_dimuonditrk_refPK_vProb = 	(Float_t)(*dimuonditrk_refPK_vProb);
out_dimuonditrk_refKP_vProb = 	(Float_t)(*dimuonditrk_refKP_vProb);
out_dimuonditrk_refPP_vProb = 	(Float_t)(*dimuonditrk_refPP_vProb);
out_dimuon_vProb = 	(Float_t)(*dimuon_vProb);
out_dimuon_vChi2 = 	(Float_t)(*dimuon_vChi2);
out_dimuon_DCA = 	(Float_t)(*dimuon_DCA);
out_dimuon_ctauPV = 	(Float_t)(*dimuon_ctauPV);
out_dimuon_ctauErrPV = 	(Float_t)(*dimuon_ctauErrPV);
out_dimuon_cosAlpha = 	(Float_t)(*dimuon_cosAlpha);
out_dimuon_triggerMatch = 	(Float_t)(*dimuon_triggerMatch);
out_dimuonditrk_vProb = 	(Float_t)(*dimuonditrk_vProb);
out_dimuonditrk_vChi2 = 	(Float_t)(*dimuonditrk_vChi2);
out_dimuonditrk_nDof = 	(Float_t)(*dimuonditrk_nDof);
out_dimuonditrk_charge = 	(Float_t)(*dimuonditrk_charge);
out_dimuonditrk_cosAlpha = 	(Float_t)(*dimuonditrk_cosAlpha);
out_dimuonditrk_ctauPV = 	(Float_t)(*dimuonditrk_ctauPV);
out_dimuonditrk_ctauErrPV = 	(Float_t)(*dimuonditrk_ctauErrPV);
out_dimuonditrk_tPFromPV = 	(Float_t)(*dimuonditrk_tPFromPV);
out_dimuonditrk_tMFromPV = 	(Float_t)(*dimuonditrk_tMFromPV);
out_dimuonditrk_cosAlphaCA = 	(Float_t)(*dimuonditrk_cosAlphaCA);
out_dimuonditrk_ctauPVCA = 	(Float_t)(*dimuonditrk_ctauPVCA);
out_dimuonditrk_ctauErrPVCA = 	(Float_t)(*dimuonditrk_ctauErrPVCA);
out_dimuonditrk_tPFromPVCA = 	(Float_t)(*dimuonditrk_tPFromPVCA);
out_dimuonditrk_tMFromPVCA = 	(Float_t)(*dimuonditrk_tMFromPVCA);
out_dimuonditrk_cosAlphaDZ = 	(Float_t)(*dimuonditrk_cosAlphaDZ);
out_dimuonditrk_ctauPVDZ = 	(Float_t)(*dimuonditrk_ctauPVDZ);
out_dimuonditrk_ctauErrPVDZ = 	(Float_t)(*dimuonditrk_ctauErrPVDZ);
out_dimuonditrk_tPFromPVDZ = 	(Float_t)(*dimuonditrk_tPFromPVDZ);
out_dimuonditrk_tMFromPVDZ = 	(Float_t)(*dimuonditrk_tMFromPVDZ);
out_dimuonditrk_cosAlphaBS = 	(Float_t)(*dimuonditrk_cosAlphaBS);
out_dimuonditrk_ctauPVBS = 	(Float_t)(*dimuonditrk_ctauPVBS);
out_dimuonditrk_ctauErrPVBS = 	(Float_t)(*dimuonditrk_ctauErrPVBS);
out_dimuonditrk_dca_m1m2 = 	(Float_t)(*dimuonditrk_dca_m1m2);
out_dimuonditrk_dca_m1t1 = 	(Float_t)(*dimuonditrk_dca_m1t1);
out_dimuonditrk_dca_m1t2 = 	(Float_t)(*dimuonditrk_dca_m1t2);
out_dimuonditrk_dca_m2t1 = 	(Float_t)(*dimuonditrk_dca_m2t1);
out_dimuonditrk_dca_m2t2 = 	(Float_t)(*dimuonditrk_dca_m2t2);
out_dimuonditrk_dca_t1t2 = 	(Float_t)(*dimuonditrk_dca_t1t2);
out_dimuonditrk_rf_vProb = 	(Float_t)(*dimuonditrk_rf_vProb);
out_dimuonditrk_rf_vChi2 = 	(Float_t)(*dimuonditrk_rf_vChi2);
out_dimuonditrk_rf_nDof = 	(Float_t)(*dimuonditrk_rf_nDof);
out_dimuonditrk_rf_cosAlpha = 	(Float_t)(*dimuonditrk_rf_cosAlpha);
out_dimuonditrk_rf_ctauPV = 	(Float_t)(*dimuonditrk_rf_ctauPV);
out_dimuonditrk_rf_ctauErrPV = 	(Float_t)(*dimuonditrk_rf_ctauErrPV);
out_dimuonditrk_rf_c_vProb = 	(Float_t)(*dimuonditrk_rf_c_vProb);
out_dimuonditrk_rf_c_vChi2 = 	(Float_t)(*dimuonditrk_rf_c_vChi2);
out_dimuonditrk_rf_c_nDof = 	(Float_t)(*dimuonditrk_rf_c_nDof);
out_dimuonditrk_rf_c_cosAlpha = 	(Float_t)(*dimuonditrk_rf_c_cosAlpha);
out_dimuonditrk_rf_c_ctauPV = 	(Float_t)(*dimuonditrk_rf_c_ctauPV);
out_dimuonditrk_rf_c_ctauErrPV = 	(Float_t)(*dimuonditrk_rf_c_ctauErrPV);
out_highKaonMatch = 	(Float_t)(*highKaonMatch);
out_lowKaonMatch = 	(Float_t)(*lowKaonMatch);
out_lowMuonMatch = 	(Float_t)(*lowMuonMatch);
out_highMuonMatch = 	(Float_t)(*highMuonMatch);
out_lowMuon_isTight = 	(Float_t)(*lowMuon_isTight);
out_lowMuon_isLoose = 	(Float_t)(*lowMuon_isLoose);
out_lowMuon_isSoft = 	(Float_t)(*lowMuon_isSoft);
out_lowMuon_isMedium = 	(Float_t)(*lowMuon_isMedium);
out_lowMuon_isHighPt = 	(Float_t)(*lowMuon_isHighPt);
out_lowMuon_isTracker = 	(Float_t)(*lowMuon_isTracker);
out_lowMuon_isGlobal = 	(Float_t)(*lowMuon_isGlobal);
out_lowMuon_NPixelHits = 	(Float_t)(*lowMuon_NPixelHits);
out_lowMuon_NStripHits = 	(Float_t)(*lowMuon_NStripHits);
out_lowMuon_NTrackhits = 	(Float_t)(*lowMuon_NTrackhits);
out_lowMuon_NBPixHits = 	(Float_t)(*lowMuon_NBPixHits);
out_lowMuon_NPixLayers = 	(Float_t)(*lowMuon_NPixLayers);
out_lowMuon_NTraLayers = 	(Float_t)(*lowMuon_NTraLayers);
out_lowMuon_NStrLayers = 	(Float_t)(*lowMuon_NStrLayers);
out_lowMuon_NBPixLayers = 	(Float_t)(*lowMuon_NBPixLayers);
out_highMuon_isTight = 	(Float_t)(*highMuon_isTight);
out_highMuon_isLoose = 	(Float_t)(*highMuon_isLoose);
out_highMuon_isSoft = 	(Float_t)(*highMuon_isSoft);
out_highMuon_isMedium = 	(Float_t)(*highMuon_isMedium);
out_highMuon_isHighPt = 	(Float_t)(*highMuon_isHighPt);
out_highMuon_isTracker = 	(Float_t)(*highMuon_isTracker);
out_highMuon_isGlobal = 	(Float_t)(*highMuon_isGlobal);
out_highMuon_NPixelHits = 	(Float_t)(*highMuon_NPixelHits);
out_highMuon_NStripHits = 	(Float_t)(*highMuon_NStripHits);
out_highMuon_NTrackhits = 	(Float_t)(*highMuon_NTrackhits);
out_highMuon_NBPixHits = 	(Float_t)(*highMuon_NBPixHits);
out_highMuon_NPixLayers = 	(Float_t)(*highMuon_NPixLayers);
out_highMuon_NTraLayers = 	(Float_t)(*highMuon_NTraLayers);
out_highMuon_NStrLayers = 	(Float_t)(*highMuon_NStrLayers);
out_highMuon_NBPixLayers = 	(Float_t)(*highMuon_NBPixLayers);
out_lowMuon_type = 	(Float_t)(*lowMuon_type);
out_highMuon_type = 	(Float_t)(*highMuon_type);
out_highKaon_NPixelHits = 	(Float_t)(*highKaon_NPixelHits);
out_highKaon_NStripHits = 	(Float_t)(*highKaon_NStripHits);
out_highKaon_NTrackhits = 	(Float_t)(*highKaon_NTrackhits);
out_highKaon_NBPixHits = 	(Float_t)(*highKaon_NBPixHits);
out_highKaon_NPixLayers = 	(Float_t)(*highKaon_NPixLayers);
out_highKaon_NTraLayers = 	(Float_t)(*highKaon_NTraLayers);
out_highKaon_NStrLayers = 	(Float_t)(*highKaon_NStrLayers);
out_highKaon_NBPixLayers = 	(Float_t)(*highKaon_NBPixLayers);
out_lowKaon_NPixelHits = 	(Float_t)(*lowKaon_NPixelHits);
out_lowKaon_NStripHits = 	(Float_t)(*lowKaon_NStripHits);
out_lowKaon_NTrackhits = 	(Float_t)(*lowKaon_NTrackhits);
out_lowKaon_NBPixHits = 	(Float_t)(*lowKaon_NBPixHits);
out_lowKaon_NPixLayers = 	(Float_t)(*lowKaon_NPixLayers);
out_lowKaon_NTraLayers = 	(Float_t)(*lowKaon_NTraLayers);
out_lowKaon_NStrLayers = 	(Float_t)(*lowKaon_NStrLayers);
out_lowKaon_NBPixLayers = 	(Float_t)(*lowKaon_NBPixLayers);
